17 12
16 14 14 14 14 14 14 14 14 14 14 14 14 14 14 14 14
16 14 14 14 14 14 14 14 14 14 14 14 14 14 14 14 14
22 14 14 14 14 14 14 14 14 14 14 14 14 14 14 14 14
16 14 14 14 14 14 14 14 14 14 14 14 14 14 14 14 14
16 14 14 14 14 14 14 14 14 14 14 14 14 14 14 14 14
16 14 14 14 14 14 14 14 14 14 14 14 14 14 14 14 14
16 14 14 14 14 14 14 14 14 14 14 14 14 14 14 14 14
16 14 14 14 14 14 14 14 14 14 14 14 14 14 14 14 14
16 14 14 14 14 14 14 14 14 14 14 14 14 14 14 14 14
16 14 14 14 14 14 14 14 14 14 14 14 14 14 14 14 14
16 14 14 14 14 14 14 14 14 14 14 14 14 14 14 14 14
16 16 16 16 16 16 16 16 16 16 16 16 16 16 16 16 16