17 12
0 0 0 0 0 0 0 0 0 0 0 0 0 0 0 0 0
5 5 0 0 0 0 0 0 0 0 0 0 0 8 8 8 0
5 5 0 0 0 0 0 0 0 10 10 10 0 8 8 8 0
5 5 0 0 0 0 0 0 0 10 10 10 0 0 7 0 0
5 5 5 0 0 0 0 0 0 0 0 0 0 0 -1 0 0
5 5 5 0 0 0 0 0 0 0 0 0 0 0 0 0 0
0 0 0 0 0 0 0 0 0 0 -1 -1 -1 -1 -1 0 0
0 8 8 8 0 0 0 0 0 0 -1 -1 -1 -1 -1 0 0
0 8 8 8 0 9 9 9 0 0 -1 -1 -1 -1 -1 0 0
0 0 7 0 0 9 9 9 0 -1 -1 -1 -1 -1 -1 1 0
0 0 -1 0 0 0 0 0 0 -1 -1 -1 -1 -1 -1 -1 0
0 0 0 0 0 0 0 0 0 0 0 0 0 0 0 0 0